NO textures/north.xpm
SO ./textures/south.xpm
WE textures/west.xpm
EA textures/east.xpm


C 225,0,0
F 220,100,0

11111
11011
10N01
11011
11111