NO ./textures/north.xpm
SO ./textures/south.xpm
WE ./textures/west.xpm
EA ./textures/east.xpm


C 225,0,0
F 220,100,0

 1111111111111111
 1000000100000001  1
 1000000000000001   
 1100110000000001    
 10000001000N0001   
 1000000100000001  
 1111111111111111 
